32	24																														
9	9	9	9	9	9	9	9	9	9	9	9	9	9	9	9	9	9	9	9	9	9	9	9	9	9	9	9	9	9	9	9
9	3	0	3	0	3	0	3	0	4	0	1	0	0	0	2	0	4	0	2	0	3	0	3	0	2	0	1	0	0	0	9
9	3	0	5	0	3	0	3	0	4	0	0	0	0	0	6	0	4	0	2	0	3	0	3	0	2	0	0	0	0	0	9
9	3	0	3	0	3	0	3	0	4	0	0	0	0	0	3	0	4	0	2	0	2	0	2	0	2	0	0	0	0	0	9
9	5	0	2	0	2	0	3	0	4	0	0	0	0	0	3	0	4	0	2	0	3	0	3	0	4	0	0	0	0	0	9
9	2	0	3	0	2	0	3	0	4	0	4	0	6	0	2	0	4	0	2	0	4	0	4	0	3	0	4	0	4	0	9
9	2	0	6	0	4	0	3	0	3	0	4	0	6	0	3	0	3	0	2	0	5	0	5	0	3	0	3	0	3	0	9
9	2	0	2	0	5	0	3	0	3	0	4	0	6	0	4	0	3	0	2	0	6	0	6	0	2	0	3	0	4	0	9
9	2	0	3	0	2	0	3	0	3	0	5	0	6	0	3	0	3	0	2	0	4	0	4	0	2	0	2	0	3	0	9
9	2	0	4	0	2	0	3	0	3	0	6	0	5	0	2	0	3	0	2	0	2	0	2	0	2	0	2	0	3	0	9
9	4	0	4	0	4	0	4	0	3	0	4	0	4	0	4	0	3	0	4	0	4	0	4	0	4	0	4	0	4	0	9
9	4	0	4	0	4	0	4	0	2	0	4	0	4	0	4	0	2	0	4	0	4	0	4	0	4	0	4	0	4	0	9
9	4	0	4	0	4	0	4	0	2	0	4	0	4	0	4	0	2	0	4	0	4	0	4	0	4	0	4	0	4	0	9
9	0	0	0	0	0	0	0	0	0	0	0	0	0	0	0	0	0	0	0	0	0	0	0	0	0	0	0	0	0	0	9
9	0	0	0	0	0	0	0	0	0	0	0	0	0	0	0	0	0	0	0	0	0	0	0	0	0	0	0	0	0	0	9
9	0	0	0	0	0	0	0	0	0	0	0	0	0	0	0	0	0	0	0	0	0	0	0	0	0	0	0	0	0	0	9
9	0	0	0	0	0	0	0	0	0	0	0	0	0	0	0	0	0	0	0	0	0	0	0	0	0	0	0	0	0	0	9
9	0	0	0	0	0	0	0	0	0	0	0	0	0	0	0	0	0	0	0	0	0	0	0	0	0	0	0	0	0	0	9
9	0	0	0	0	0	0	0	0	0	0	0	0	0	0	0	0	0	0	0	0	0	0	0	0	0	0	0	0	0	0	9
9	0	0	0	0	0	0	0	0	0	0	0	0	0	0	0	0	0	0	0	0	0	0	0	0	0	0	0	0	0	0	9
9	0	0	0	0	0	0	0	0	0	0	0	0	0	0	0	0	0	0	0	0	0	0	0	0	0	0	0	0	0	0	9
9	0	0	0	0	0	0	0	0	0	0	0	0	0	0	0	0	0	0	0	0	0	0	0	0	0	0	0	0	0	0	9
9	0	0	0	0	0	0	0	0	0	0	0	0	0	0	0	0	0	0	0	0	0	0	0	0	0	0	0	0	0	0	9
9	9	9	9	9	9	9	9	9	9	9	9	9	9	9	9	9	9	9	9	9	9	9	9	9	9	9	9	9	9	9	9